,name,diff_num,hunk_num,func_num,Memoery_num_total,Memoery_del_num,Memoery_add_num,Conditions_num_total,Conditions_num_del,Conditions_num_add,Jump_num_total,Jump_num_del,Jump_num_add,Loop_num_total,Loop_num_del,Loop_num_add,Arithmetic_num_total,Arithmetic_num_del,Arithmetic_num_add,relation_num_total,relation_num_del,relation_num_add,Logic_num_total,Logic_num_del,Logic_num_add,bitwise_num_total,bitwise_num_del,bitwise_num_add,Funccall_num_total,Funccall_num_del,Funccall_num_add,Variables_num_total,Variables_num_del,Variables_num_add
0,./source1012/2017/CVE-2017-0611/yerunyuan1982%kernel/cm-14.1/9d35b8fe92dd_patch/equal_file_patch/d5e8a6aba57.patch,1,3,1,3,0,3,2,0,2,2,0,2,0,0,0,13,1,12,2,0,2,0,0,0,0,0,0,1,0,1,17,2,17
1,./source1012/2017/CVE-2017-0611/yerunyuan1982%kernel/cm-14.1/9d35b8fe92dd_patch/equal_file_patch/3d04f218e88.patch,1,3,1,3,0,3,2,0,2,2,0,2,0,0,0,13,1,12,2,0,2,0,0,0,0,0,0,1,0,1,17,2,17
2,./source1012/2017/CVE-2017-0611/yerunyuan1982%kernel/cm-14.1/9d35b8fe92dd_patch/equal_file_patch/8f15f1dcbf0.patch,1,3,1,3,0,3,2,0,2,2,0,2,0,0,0,13,1,12,2,0,2,0,0,0,0,0,0,1,0,1,17,2,17
3,./source1012/2017/CVE-2017-0611/yerunyuan1982%kernel/cm-14.1/9d35b8fe92dd_patch/equal_file_patch/3425234df96.patch,1,3,1,3,0,3,2,0,2,2,0,2,0,0,0,13,1,12,2,0,2,0,0,0,0,0,0,1,0,1,17,2,17
4,./source1012/2017/CVE-2017-0611/yerunyuan1982%kernel/cm-14.1/9d35b8fe92dd_patch/equal_file_patch/25658c09936.patch,1,3,1,3,0,3,2,0,2,2,0,2,0,0,0,13,1,12,2,0,2,0,0,0,0,0,0,1,0,1,17,2,17
5,./source1012/2017/CVE-2017-0611/yerunyuan1982%kernel/cm-14.1/9d35b8fe92dd_patch/equal_file_patch/9d35b8fe92dd.patch,1,3,1,3,0,3,2,0,2,2,0,2,0,0,0,13,1,12,2,0,2,0,0,0,0,0,0,1,0,1,17,2,17
6,./source1012/2017/CVE-2017-1000199/open-iscsi%tcmu-runner/main/8a6331a56a50_patch/equal_file_patch/00c553e.patch,1,6,1,0,0,0,0,0,0,0,0,0,0,0,0,14,7,7,4,2,2,2,1,1,2,1,1,5,3,4,19,18,19
7,./source1012/2017/CVE-2017-1000199/open-iscsi%tcmu-runner/main/8a6331a56a50_patch/equal_file_patch/c09740a240c0.patch,1,6,1,0,0,0,0,0,0,0,0,0,0,0,0,14,7,7,4,2,2,2,1,1,2,1,1,5,3,4,19,18,19
8,./source1012/2017/CVE-2017-1000199/open-iscsi%tcmu-runner/main/8a6331a56a50_patch/equal_file_patch/29dfcb935a90.patch,1,6,1,0,0,0,0,0,0,0,0,0,0,0,0,14,7,7,4,2,2,2,1,1,2,1,1,5,3,4,19,18,19
9,./source1012/2017/CVE-2017-1000199/open-iscsi%tcmu-runner/main/8a6331a56a50_patch/equal_file_patch/8017962.patch,1,6,1,0,0,0,0,0,0,0,0,0,0,0,0,14,7,7,4,2,2,2,1,1,2,1,1,5,3,4,19,18,19
10,./source1012/2017/CVE-2017-1000199/open-iscsi%tcmu-runner/main/8a6331a56a50_patch/equal_file_patch/8df2f14.patch,1,5,1,0,0,0,0,0,0,0,0,0,0,0,0,14,7,7,4,2,2,2,1,1,2,1,1,4,3,3,18,18,18
11,./source1012/2017/CVE-2017-1000199/open-iscsi%tcmu-runner/main/8a6331a56a50_patch/equal_file_patch/ee45f8b.patch,1,5,1,0,0,0,0,0,0,0,0,0,0,0,0,14,7,7,4,2,2,2,1,1,2,1,1,4,3,3,18,18,18
12,./source1012/2017/CVE-2017-11734/libming%libming/master/3120f1cdae0c5232a4fb15e5ce42b8c455b43379_patch/equal_file_patch/6e5a28dc.patch,10,15,2,0,0,0,15,5,10,10,0,10,0,0,0,20,5,15,35,10,25,15,5,10,0,0,0,3,1,3,21,8,18
13,./source1012/2017/CVE-2017-11734/libming%libming/master/1f5976337d2cf02d5f709cb1d0dac479976e5f94_patch/equal_file_patch/9141f1df.patch,4,4,1,0,0,0,4,0,4,0,0,0,0,0,0,8,4,4,12,4,8,4,0,4,0,0,0,0,0,0,7,6,7
14,./source1012/2017/CVE-2017-11734/libming%libming/master/1f5976337d2cf02d5f709cb1d0dac479976e5f94_patch/equal_file_patch/6e5a28dc.patch,8,12,2,0,0,0,8,0,8,8,0,8,0,0,0,16,4,12,24,4,20,8,0,8,0,0,0,3,1,3,20,7,18
15,./source1012/2017/CVE-2017-11734/libming%libming/master/2027b24f403a859016a70bbdc79a8da1d6f128eb_patch/equal_file_patch/9141f1df.patch,8,8,2,0,0,0,20,0,20,4,0,4,0,0,0,16,4,12,20,4,16,4,0,4,0,0,0,1,0,1,11,6,11
16,./source1012/2017/CVE-2017-11734/libming%libming/master/2027b24f403a859016a70bbdc79a8da1d6f128eb_patch/equal_file_patch/6e5a28dc.patch,8,16,3,0,0,0,24,0,24,12,0,12,0,0,0,24,4,20,32,4,28,8,0,8,0,0,0,3,1,3,24,7,22
17,./source1012/2017/CVE-2017-11874/hexloop%ChakraCore/master/0c854e68b198_patch/equal_file_patch/866a382a4.patch,2,8,2,2,1,1,14,9,5,0,0,0,4,2,2,26,13,13,14,9,5,20,11,9,0,0,0,11,10,8,16,13,14
18,./source1012/2017/CVE-2017-11874/hexloop%ChakraCore/master/0c854e68b198_patch/equal_file_patch/d28ff47fb.patch,1,1,1,0,0,0,6,0,6,0,0,0,0,0,0,19,4,15,13,4,9,2,0,2,1,0,1,8,1,8,19,3,19
19,./source1012/2017/CVE-2017-11874/hexloop%ChakraCore/master/0c854e68b198_patch/equal_file_patch/ca083a638.patch,1,1,1,0,0,0,6,0,6,0,0,0,0,0,0,19,4,15,13,4,9,2,0,2,1,0,1,8,1,8,19,3,19
20,./source1012/2017/CVE-2017-11874/hexloop%ChakraCore/master/0c854e68b198_patch/equal_file_patch/bbc4c2e8df02.patch,2,8,2,2,1,1,14,9,5,0,0,0,4,2,2,26,13,13,14,9,5,20,11,9,0,0,0,11,10,8,16,13,14
21,./source1012/2017/CVE-2017-11874/hexloop%ChakraCore/master/0c854e68b198_patch/equal_file_patch/a7f6ef7b3.patch,1,1,1,0,0,0,6,0,6,0,0,0,0,0,0,17,4,13,14,4,10,3,0,3,1,0,1,6,1,6,16,3,16
22,./source1012/2017/CVE-2017-11874/hexloop%ChakraCore/master/0c854e68b198_patch/equal_file_patch/28d68d293.patch,1,1,1,0,0,0,3,0,3,0,0,0,0,0,0,12,4,8,12,4,8,0,0,0,1,0,1,3,1,3,4,3,4
23,./source1012/2017/CVE-2017-13007/the-tcpdump-group%tcpdump/coverity_scan/ca336198e8be_patch/equal_file_patch/ee46167b.patch,1,9,1,0,0,0,1,0,1,6,3,3,0,0,0,22,8,14,7,3,4,0,0,0,7,6,1,5,3,4,21,14,19
24,./source1012/2017/CVE-2017-13007/the-tcpdump-group%tcpdump/coverity_scan/ca336198e8be_patch/equal_file_patch/6288c273b66f.patch,1,9,1,3,2,1,8,5,3,7,4,3,0,0,0,37,9,28,20,8,12,2,2,0,7,6,1,6,4,5,24,19,23
25,./source1012/2017/CVE-2017-13007/the-tcpdump-group%tcpdump/coverity_scan/ca336198e8be_patch/equal_file_patch/9edeb142.patch,1,8,1,3,2,1,7,4,3,6,3,3,0,0,0,22,8,14,13,7,6,2,2,0,7,6,1,5,3,4,22,17,20
26,./source1012/2017/CVE-2017-13007/the-tcpdump-group%tcpdump/coverity_scan/ca336198e8be_patch/equal_file_patch/845d1aad.patch,1,8,1,3,2,1,7,4,3,6,3,3,0,0,0,22,8,14,13,7,6,2,2,0,7,6,1,5,3,4,22,17,20
27,./source1012/2017/CVE-2017-13007/the-tcpdump-group%tcpdump/coverity_scan/ca336198e8be_patch/equal_file_patch/d9ed0221.patch,1,8,1,3,2,1,7,4,3,6,3,3,0,0,0,22,8,14,13,7,6,2,2,0,7,6,1,5,3,4,22,17,20
28,./source1012/2017/CVE-2017-13007/the-tcpdump-group%tcpdump/coverity_scan/ca336198e8be_patch/equal_file_patch/74e34812.patch,1,9,1,3,2,1,8,5,3,8,4,4,0,0,0,37,9,28,20,8,12,2,2,0,7,6,1,6,4,5,24,19,23
29,./source1012/2017/CVE-2017-13139/ImageMagick%ImageMagick/main/67a4360546ce_patch/equal_file_patch/75f49a493.patch,1,4,1,0,0,0,5,0,5,4,0,4,1,0,1,77,32,45,11,5,6,3,1,2,45,22,23,5,4,5,22,21,22
30,./source1012/2017/CVE-2017-13139/ImageMagick%ImageMagick/main/67a4360546ce_patch/equal_file_patch/3f1acfa71.patch,1,4,1,0,0,0,5,0,5,4,0,4,1,0,1,77,32,45,11,5,6,3,1,2,45,22,23,5,4,5,22,21,22
31,./source1012/2017/CVE-2017-13139/ImageMagick%ImageMagick/main/67a4360546ce_patch/equal_file_patch/ecd58e8ec.patch,1,4,1,0,0,0,5,0,5,4,0,4,1,0,1,77,32,45,11,5,6,3,1,2,45,22,23,5,4,5,22,21,22
32,./source1012/2017/CVE-2017-13139/ImageMagick%ImageMagick/main/67a4360546ce_patch/equal_file_patch/c475e5eb6.patch,1,6,1,0,0,0,5,0,5,4,0,4,1,0,1,77,32,45,11,5,6,3,1,2,45,22,23,5,4,5,23,22,23
33,./source1012/2017/CVE-2017-13139/ImageMagick%ImageMagick/main/67a4360546ce_patch/equal_file_patch/881bb6b45.patch,1,4,1,0,0,0,5,0,5,4,0,4,1,0,1,77,32,45,11,5,6,3,1,2,45,22,23,5,4,5,22,21,22
34,./source1012/2017/CVE-2017-13139/ImageMagick%ImageMagick/main/67a4360546ce_patch/equal_file_patch/9e5ad8f61.patch,1,4,1,0,0,0,5,0,5,4,0,4,1,0,1,77,32,45,11,5,6,3,1,2,45,22,23,5,4,5,22,21,22
35,./source1012/2017/CVE-2017-13146/ImageMagick%ImageMagick/main/83e0f8ffd7ee_patch/equal_file_patch/deb6c5268.patch,1,34,1,3,1,2,19,6,13,15,6,9,4,2,2,245,117,128,22,8,14,15,6,9,20,10,10,15,9,13,43,34,40
36,./source1012/2017/CVE-2017-13146/ImageMagick%ImageMagick/main/83e0f8ffd7ee_patch/equal_file_patch/fb5f540b2.patch,1,31,1,3,1,2,19,6,13,12,5,7,4,2,2,241,116,125,23,8,15,16,6,10,20,10,10,14,8,12,44,32,41
37,./source1012/2017/CVE-2017-13146/ImageMagick%ImageMagick/main/83e0f8ffd7ee_patch/equal_file_patch/7ba113a0d26b.patch,1,21,1,1,1,0,34,15,19,13,8,5,7,2,5,220,161,59,44,19,25,29,12,17,46,36,10,21,13,17,73,42,58
38,./source1012/2017/CVE-2017-13146/ImageMagick%ImageMagick/main/83e0f8ffd7ee_patch/equal_file_patch/7b8159c17.patch,1,34,1,3,1,2,19,6,13,15,6,9,4,2,2,245,117,128,22,8,14,15,6,9,20,10,10,15,9,13,43,34,40
39,./source1012/2017/CVE-2017-13146/ImageMagick%ImageMagick/main/83e0f8ffd7ee_patch/equal_file_patch/975365af8.patch,1,31,1,3,1,2,19,6,13,13,5,8,4,2,2,239,116,123,22,8,14,15,6,9,20,10,10,12,8,11,41,32,37
40,./source1012/2017/CVE-2017-13146/ImageMagick%ImageMagick/main/83e0f8ffd7ee_patch/equal_file_patch/ae784baf7.patch,1,31,1,3,1,2,19,6,13,13,5,8,4,2,2,239,116,123,22,8,14,15,6,9,20,10,10,12,8,11,41,32,37
41,./source1012/2017/CVE-2017-14156/openbmc%linux/dev-5.4/4e5639449069_patch/equal_file_patch/ed8f854d8ca4.patch,8,32,1,0,0,0,24,8,16,0,0,0,0,0,0,128,40,88,64,24,40,0,0,0,0,0,0,3,3,3,14,10,14
42,./source1012/2017/CVE-2017-14156/openbmc%linux/dev-5.4/4e5639449069_patch/equal_file_patch/d6d5df1db6e9.patch,8,32,1,0,0,0,24,8,16,0,0,0,0,0,0,128,40,88,64,24,40,0,0,0,0,0,0,3,3,3,14,10,14
43,./source1012/2017/CVE-2017-14156/openbmc%linux/dev-5.4/4e5639449069_patch/equal_file_patch/eb27d232ba71.patch,8,32,1,0,0,0,24,8,16,0,0,0,0,0,0,128,40,88,64,24,40,0,0,0,0,0,0,3,3,3,14,10,14
44,./source1012/2017/CVE-2017-14156/openbmc%linux/dev-5.4/4e5639449069_patch/equal_file_patch/61b4cec407b5.patch,8,48,1,8,0,8,64,24,40,8,0,8,0,0,0,136,40,96,80,32,48,24,8,16,0,0,0,4,4,4,18,12,18
45,./source1012/2017/CVE-2017-16536/SUSE%kernel/SLE15-SP4-RT/b8c2c66f260e_patch/equal_file_patch/302df6e63042.patch,1,1,1,0,0,0,5,2,3,0,0,0,0,0,0,2,1,1,4,2,2,2,0,2,0,0,0,0,0,0,3,3,3
46,./source1012/2017/CVE-2017-16536/SUSE%kernel/SLE15-SP4-RT/b8c2c66f260e_patch/equal_file_patch/f8eb1cd7c3eb.patch,1,1,1,0,0,0,5,2,3,0,0,0,0,0,0,2,1,1,4,2,2,2,0,2,0,0,0,0,0,0,3,3,3
47,./source1012/2017/CVE-2017-16536/SUSE%kernel/SLE15-SP4-RT/b8c2c66f260e_patch/equal_file_patch/3bd19a5549b3.patch,1,1,1,0,0,0,5,2,3,0,0,0,0,0,0,2,1,1,4,2,2,2,0,2,0,0,0,0,0,0,3,3,3
48,./source1012/2017/CVE-2017-16536/SUSE%kernel/SLE15-SP4-RT/b8c2c66f260e_patch/equal_file_patch/0eac930114cc.patch,1,1,1,0,0,0,5,2,3,0,0,0,0,0,0,2,1,1,4,2,2,2,0,2,0,0,0,0,0,0,3,3,3
49,./source1012/2017/CVE-2017-16536/SUSE%kernel/SLE15-SP4-RT/b8c2c66f260e_patch/equal_file_patch/80cb813617a4.patch,1,1,1,0,0,0,5,2,3,0,0,0,0,0,0,2,1,1,4,2,2,2,0,2,0,0,0,0,0,0,3,3,3
50,./source1012/2017/CVE-2017-16536/SUSE%kernel/SLE15-SP4-RT/b8c2c66f260e_patch/equal_file_patch/4b859fe43a63.patch,1,1,1,0,0,0,5,2,3,0,0,0,0,0,0,2,1,1,4,2,2,2,0,2,0,0,0,0,0,0,3,3,3
51,./source1012/2017/CVE-2017-16648/torvalds%linux/master/5d352e69c60e_patch/equal_file_patch/96a6de1a541c.patch,1,2,1,2,1,1,2,1,1,1,1,0,0,0,0,4,3,1,3,2,1,1,1,0,0,0,0,1,1,1,5,5,2
52,./source1012/2017/CVE-2017-16648/torvalds%linux/master/5d352e69c60e_patch/equal_file_patch/d36260050e18.patch,1,2,1,2,1,1,2,1,1,1,1,0,0,0,0,4,3,1,3,2,1,1,1,0,0,0,0,1,1,1,5,5,2
53,./source1012/2017/CVE-2017-16648/torvalds%linux/master/5d352e69c60e_patch/equal_file_patch/5d352e69c60e.patch,1,2,1,4,2,2,3,1,2,1,1,0,0,0,0,4,3,1,3,2,1,1,1,0,0,0,0,2,2,2,5,5,2
54,./source1012/2017/CVE-2017-16648/torvalds%linux/master/5d352e69c60e_patch/equal_file_patch/0af5cb349a2c.patch,1,2,1,2,1,1,2,1,1,1,1,0,0,0,0,4,3,1,3,2,1,1,1,0,0,0,0,1,1,1,5,5,2
55,./source1012/2017/CVE-2017-16648/torvalds%linux/master/5d352e69c60e_patch/equal_file_patch/68c5735eaa5e.patch,1,2,1,2,1,1,2,1,1,1,1,0,0,0,0,4,3,1,3,2,1,1,1,0,0,0,0,1,1,1,5,5,2
56,./source1012/2017/CVE-2017-16648/torvalds%linux/master/5d352e69c60e_patch/equal_file_patch/71f3a82fab1b.patch,1,2,1,2,1,1,2,1,1,1,1,0,0,0,0,4,3,1,3,2,1,1,1,0,0,0,0,1,1,1,5,5,2
57,./source1012/2017/CVE-2017-16648/torvalds%linux/master/68c5735eaa5e_patch/equal_file_patch/35110e38e6c5.patch,1,1,1,2,1,1,1,1,0,0,0,0,0,0,0,0,0,0,0,0,0,0,0,0,0,0,0,1,1,1,1,1,1
58,./source1012/2017/CVE-2017-16648/torvalds%linux/master/68c5735eaa5e_patch/equal_file_patch/a9a08845e9ac.patch,1,1,1,2,1,1,1,1,0,0,0,0,0,0,0,0,0,0,0,0,0,0,0,0,0,0,0,1,1,1,1,1,1
59,./source1012/2017/CVE-2017-16648/torvalds%linux/master/68c5735eaa5e_patch/equal_file_patch/68c5735eaa5e.patch,1,1,1,2,1,1,1,1,0,0,0,0,0,0,0,0,0,0,0,0,0,0,0,0,0,0,0,1,1,1,1,1,1
60,./source1012/2017/CVE-2017-16648/torvalds%linux/master/68c5735eaa5e_patch/equal_file_patch/e7345f92c27a.patch,1,1,1,2,1,1,1,1,0,0,0,0,0,0,0,0,0,0,0,0,0,0,0,0,0,0,0,1,1,1,1,1,1
61,./source1012/2017/CVE-2017-16648/torvalds%linux/master/68c5735eaa5e_patch/equal_file_patch/134bf98c5596.patch,1,1,1,2,1,1,1,1,0,0,0,0,0,0,0,0,0,0,0,0,0,0,0,0,0,0,0,1,1,1,1,1,1
62,./source1012/2017/CVE-2017-16648/torvalds%linux/master/68c5735eaa5e_patch/equal_file_patch/ef1c4a6fa91b.patch,1,1,1,2,1,1,1,1,0,0,0,0,0,0,0,0,0,0,0,0,0,0,0,0,0,0,0,1,1,1,1,1,1
63,./source1012/2017/CVE-2017-16648/openSUSE%kernel/SLE15-SP4-RT/925d0ae088fe_patch/equal_file_patch/11a145c2bcb4.patch,1,1,1,2,1,1,1,1,0,0,0,0,0,0,0,0,0,0,0,0,0,0,0,0,0,0,0,1,1,1,1,1,1
64,./source1012/2017/CVE-2017-16648/openSUSE%kernel/SLE15-SP4-RT/925d0ae088fe_patch/equal_file_patch/8fb67abf039d.patch,1,1,1,2,1,1,1,1,0,0,0,0,0,0,0,0,0,0,0,0,0,0,0,0,0,0,0,1,1,1,1,1,1
65,./source1012/2017/CVE-2017-16648/openSUSE%kernel/SLE15-SP4-RT/925d0ae088fe_patch/equal_file_patch/65bad53e0a19.patch,1,1,1,2,1,1,1,1,0,0,0,0,0,0,0,0,0,0,0,0,0,0,0,0,0,0,0,1,1,1,1,1,1
66,./source1012/2017/CVE-2017-16648/openSUSE%kernel/SLE15-SP4-RT/925d0ae088fe_patch/equal_file_patch/2bc3e547bf40.patch,1,1,1,2,1,1,1,1,0,0,0,0,0,0,0,0,0,0,0,0,0,0,0,0,0,0,0,1,1,1,1,1,1
67,./source1012/2017/CVE-2017-16648/openSUSE%kernel/SLE15-SP4-RT/925d0ae088fe_patch/equal_file_patch/834a3860643f.patch,1,1,1,2,1,1,1,1,0,0,0,0,0,0,0,0,0,0,0,0,0,0,0,0,0,0,0,1,1,1,1,1,1
68,./source1012/2017/CVE-2017-16648/openSUSE%kernel/SLE15-SP4-RT/925d0ae088fe_patch/equal_file_patch/5bc5cafce717.patch,1,1,1,2,1,1,1,1,0,0,0,0,0,0,0,0,0,0,0,0,0,0,0,0,0,0,0,1,1,1,1,1,1
69,./source1012/2017/CVE-2017-16995/konradybcio%linux/8994fun/ead68f216110_patch/equal_file_patch/237f83dfbe66.patch,1,9,1,3,0,3,12,1,11,1,0,1,2,0,2,70,20,50,45,11,34,5,0,5,5,2,3,11,6,9,36,16,34
70,./source1012/2017/CVE-2017-16995/konradybcio%linux/8994fun/ead68f216110_patch/equal_file_patch/9f51ae62c84a.patch,1,8,1,0,0,0,6,1,5,1,0,1,1,0,1,28,10,18,20,6,14,4,0,4,2,1,1,9,5,7,29,12,27
71,./source1012/2017/CVE-2017-16995/konradybcio%linux/8994fun/ead68f216110_patch/equal_file_patch/95e6ba513316.patch,1,9,1,3,0,3,12,1,11,1,0,1,2,0,2,70,20,50,45,11,34,5,0,5,5,2,3,11,6,9,36,16,34
72,./source1012/2017/CVE-2017-16995/konradybcio%linux/8994fun/ead68f216110_patch/equal_file_patch/5211da9ca526.patch,1,8,1,0,0,0,6,1,5,1,0,1,1,0,1,28,10,18,20,6,14,4,0,4,2,1,1,9,5,7,29,12,27
73,./source1012/2017/CVE-2017-16995/konradybcio%linux/8994fun/ead68f216110_patch/equal_file_patch/40e196a906d9.patch,1,10,1,0,0,0,7,1,6,0,0,0,0,0,0,45,16,29,27,10,17,0,0,0,4,2,2,8,6,6,27,15,25
74,./source1012/2017/CVE-2017-16995/konradybcio%linux/8994fun/ead68f216110_patch/equal_file_patch/726ba84b50ac.patch,1,3,1,0,0,0,4,0,4,1,0,1,1,0,1,17,7,10,15,5,10,4,0,4,2,1,1,6,3,4,18,6,17
75,./source1012/2017/CVE-2017-17864/torvalds%linux/master/ead68f216110_patch/equal_file_patch/c93d9218ea56.patch,1,5,1,0,0,0,11,8,3,3,2,1,0,0,0,11,9,2,12,12,0,4,4,0,0,0,0,2,2,1,19,15,6
76,./source1012/2017/CVE-2017-17864/torvalds%linux/master/ead68f216110_patch/equal_file_patch/519be6995c31.patch,1,4,1,0,0,0,10,7,3,2,1,1,0,0,0,9,7,2,9,9,0,4,4,0,0,0,0,2,2,1,18,14,6
77,./source1012/2017/CVE-2017-17864/torvalds%linux/master/ead68f216110_patch/equal_file_patch/9f51ae62c84a.patch,1,4,1,0,0,0,10,7,3,2,1,1,0,0,0,9,7,2,9,9,0,4,4,0,0,0,0,2,2,1,18,14,6
78,./source1012/2017/CVE-2017-17864/torvalds%linux/master/ead68f216110_patch/equal_file_patch/11a827294755.patch,1,6,1,0,0,0,18,8,10,4,2,2,0,0,0,13,9,4,14,12,2,7,4,3,0,0,0,2,2,1,26,15,14
79,./source1012/2017/CVE-2017-17864/torvalds%linux/master/ead68f216110_patch/equal_file_patch/da0f38202986.patch,1,5,1,0,0,0,15,8,7,3,2,1,0,0,0,11,9,2,12,12,0,4,4,0,0,0,0,2,2,1,23,15,10
80,./source1012/2017/CVE-2017-17864/torvalds%linux/master/ead68f216110_patch/equal_file_patch/bd2463ac7d7e.patch,1,6,1,0,0,0,18,8,10,4,2,2,0,0,0,13,9,4,14,12,2,7,4,3,0,0,0,2,2,1,26,15,14
81,./source1012/2017/CVE-2017-5504/jasper-maint%jasper/master/e2f2e5f4022b_patch/equal_file_patch/b417f867bf93.patch,3,6,2,0,0,0,6,0,6,5,0,5,1,0,1,36,10,26,30,10,20,10,3,7,0,0,0,1,1,1,40,17,40
82,./source1012/2017/CVE-2017-5504/jasper-maint%jasper/master/e2f2e5f4022b_patch/equal_file_patch/42b167ec7a2e.patch,1,6,1,0,0,0,5,0,5,4,0,4,1,0,1,32,8,24,26,8,18,7,2,5,0,0,0,1,1,1,35,14,35
83,./source1012/2017/CVE-2017-5504/jasper-maint%jasper/master/e2f2e5f4022b_patch/equal_file_patch/b338ba9.patch,3,3,2,0,0,0,3,0,3,3,0,3,0,0,0,22,10,12,20,10,10,7,3,4,0,0,0,1,1,1,19,17,19
84,./source1012/2017/CVE-2017-5504/jasper-maint%jasper/master/e2f2e5f4022b_patch/equal_file_patch/15de202dbcb4.patch,1,9,1,0,0,0,5,0,5,4,0,4,1,0,1,34,10,24,26,8,18,7,2,5,0,0,0,2,2,1,38,18,35
85,./source1012/2017/CVE-2017-5504/jasper-maint%jasper/master/e2f2e5f4022b_patch/equal_file_patch/7e4f3a7f0b25.patch,2,1,1,0,0,0,1,0,1,1,0,1,0,0,0,4,2,2,4,2,2,3,1,2,0,0,0,1,1,1,8,7,8
86,./source1012/2017/CVE-2017-5504/jasper-maint%jasper/master/e2f2e5f4022b_patch/equal_file_patch/d06b17d.patch,3,5,2,0,0,0,4,0,4,4,0,4,1,0,1,33,10,23,26,10,16,9,3,6,0,0,0,1,1,1,38,17,38
87,./source1012/2017/CVE-2017-7555/hercules-team%augeas/rel-1.8.1/7a9177a960bb_patch/equal_file_patch/aacc8ac0.patch,0,0,0,0,0,0,0,0,0,0,0,0,0,0,0,0,0,0,0,0,0,0,0,0,0,0,0,0,0,0,0,0,0
88,./source1012/2017/CVE-2017-7555/hercules-team%augeas/rel-1.8.1/7a9177a960bb_patch/equal_file_patch/7a9177a960bb.patch,0,0,0,0,0,0,0,0,0,0,0,0,0,0,0,0,0,0,0,0,0,0,0,0,0,0,0,0,0,0,0,0,0
89,./source1012/2017/CVE-2017-7895/torvalds%linux/master/8b5d11e4b095_patch/equal_file_patch/4dd3c2e5a422.patch,1,8,2,0,0,0,2,0,2,2,0,2,0,0,0,54,21,33,20,6,14,0,0,0,0,0,0,2,2,2,20,17,20
90,./source1012/2017/CVE-2017-7895/torvalds%linux/master/8b5d11e4b095_patch/equal_file_patch/3b1e342be265.patch,1,3,1,0,0,0,1,0,1,1,0,1,0,0,0,30,13,17,13,5,8,0,0,0,0,0,0,0,0,0,12,11,12
91,./source1012/2017/CVE-2017-7895/torvalds%linux/master/8b5d11e4b095_patch/equal_file_patch/08dffcc7d94b.patch,1,5,1,0,0,0,1,0,1,1,0,1,1,1,0,64,37,27,26,15,11,0,0,0,0,0,0,2,2,1,24,22,17
92,./source1012/2017/CVE-2017-7895/torvalds%linux/master/8b5d11e4b095_patch/equal_file_patch/f419f031de14.patch,1,5,1,0,0,0,1,0,1,1,0,1,1,1,0,64,37,27,26,15,11,0,0,0,0,0,0,2,2,1,24,22,17
93,./source1012/2017/CVE-2017-7895/torvalds%linux/master/8b5d11e4b095_patch/equal_file_patch/5e4d659713f5.patch,1,4,1,0,0,0,1,0,1,1,0,1,1,1,0,57,35,22,23,14,9,0,0,0,0,0,0,2,2,1,23,21,16
94,./source1012/2017/CVE-2017-7895/torvalds%linux/master/8b5d11e4b095_patch/equal_file_patch/c70422f760c1.patch,1,3,1,0,0,0,1,0,1,1,0,1,0,0,0,30,13,17,13,5,8,0,0,0,0,0,0,0,0,0,12,11,12
95,./source1012/2017/CVE-2017-9120/php%php-src/PHP-5.5.16/088e2692c3d1_patch/equal_file_patch/ddda65a9a6.patch,4,41,6,21,4,17,139,26,113,45,10,35,6,0,6,227,45,182,103,28,75,67,11,56,38,7,31,60,13,56,126,53,121
96,./source1012/2017/CVE-2017-9120/php%php-src/PHP-5.5.16/088e2692c3d1_patch/equal_file_patch/cb26223cb3.patch,4,45,5,24,6,18,154,36,118,52,15,37,6,0,6,219,39,180,93,23,70,72,16,56,38,9,29,62,17,57,136,64,128
97,./source1012/2017/CVE-2017-9120/php%php-src/PHP-5.5.16/088e2692c3d1_patch/equal_file_patch/0367674517.patch,4,32,6,14,2,12,133,23,110,40,3,37,3,0,3,196,33,163,106,25,81,75,10,65,34,4,30,51,8,51,106,34,105
98,./source1012/2017/CVE-2017-9120/php%php-src/PHP-5.5.16/088e2692c3d1_patch/equal_file_patch/b408366658.patch,4,45,5,24,6,18,154,36,118,52,15,37,6,0,6,219,39,180,93,23,70,72,16,56,38,9,29,62,17,57,136,64,128
99,./source1012/2017/CVE-2017-9120/php%php-src/PHP-5.5.16/088e2692c3d1_patch/equal_file_patch/f3d11b4415.patch,4,43,5,20,4,16,152,35,117,52,15,37,6,0,6,213,37,176,91,22,69,72,16,56,36,8,28,59,15,55,131,58,124
100,./source1012/2017/CVE-2017-9120/php%php-src/PHP-5.5.16/088e2692c3d1_patch/equal_file_patch/cd236521f4.patch,4,46,5,24,6,18,154,36,118,52,15,37,6,0,6,219,39,180,93,23,70,72,16,56,38,9,29,62,17,57,136,64,128
101,./source1012/2018/CVE-2018-10858/scabrero%samba/dfs-r-server/be3d4b2d8526_patch/equal_file_patch/eddcbfea91d.patch,1,1,1,0,0,0,2,1,1,0,0,0,0,0,0,0,0,0,2,1,1,0,0,0,0,0,0,0,0,0,2,2,2
102,./source1012/2018/CVE-2018-10858/scabrero%samba/dfs-r-server/be3d4b2d8526_patch/equal_file_patch/6f9eb617e37.patch,1,1,1,0,0,0,2,1,1,0,0,0,0,0,0,0,0,0,2,1,1,0,0,0,0,0,0,0,0,0,2,2,2
103,./source1012/2018/CVE-2018-10858/scabrero%samba/dfs-r-server/be3d4b2d8526_patch/equal_file_patch/a9758f413d0.patch,1,1,1,0,0,0,2,1,1,0,0,0,0,0,0,0,0,0,2,1,1,0,0,0,0,0,0,0,0,0,2,2,2
104,./source1012/2018/CVE-2018-10858/scabrero%samba/dfs-r-server/be3d4b2d8526_patch/equal_file_patch/bbb9f57603d.patch,1,1,1,0,0,0,2,1,1,0,0,0,0,0,0,0,0,0,2,1,1,0,0,0,0,0,0,0,0,0,2,2,2
105,./source1012/2018/CVE-2018-10858/scabrero%samba/dfs-r-server/be3d4b2d8526_patch/equal_file_patch/46e171e2e07.patch,1,1,1,0,0,0,2,1,1,0,0,0,0,0,0,0,0,0,2,1,1,0,0,0,0,0,0,0,0,0,2,2,2
106,./source1012/2018/CVE-2018-10858/scabrero%samba/dfs-r-server/be3d4b2d8526_patch/equal_file_patch/30277feb839.patch,1,1,1,0,0,0,2,1,1,0,0,0,0,0,0,0,0,0,2,1,1,0,0,0,0,0,0,0,0,0,2,2,2
107,./source1012/2018/CVE-2018-10858/freewind%samba/mac-4.8.9/47081d9de813_patch/equal_file_patch/01a76b2b14.patch,2,8,3,0,0,0,5,0,5,6,0,6,0,0,0,15,0,15,8,0,8,0,0,0,0,0,0,2,1,2,15,4,15
108,./source1012/2018/CVE-2018-10858/freewind%samba/mac-4.8.9/47081d9de813_patch/equal_file_patch/a895d2e2f8.patch,2,8,3,0,0,0,5,0,5,6,0,6,0,0,0,15,0,15,8,0,8,0,0,0,0,0,0,2,1,2,15,4,15
109,./source1012/2018/CVE-2018-10858/freewind%samba/mac-4.8.9/47081d9de813_patch/equal_file_patch/a4021fb56d.patch,2,8,3,0,0,0,5,0,5,6,0,6,0,0,0,15,0,15,8,0,8,0,0,0,0,0,0,2,1,2,15,4,15
110,./source1012/2018/CVE-2018-10858/freewind%samba/mac-4.8.9/47081d9de813_patch/equal_file_patch/5a01f6c746.patch,2,8,3,0,0,0,5,0,5,6,0,6,0,0,0,15,0,15,8,0,8,0,0,0,0,0,0,2,1,2,15,4,15
111,./source1012/2018/CVE-2018-10858/freewind%samba/mac-4.8.9/47081d9de813_patch/equal_file_patch/066d0ee3c9.patch,2,8,3,0,0,0,5,0,5,6,0,6,0,0,0,15,0,15,8,0,8,0,0,0,0,0,0,2,1,2,15,4,15
112,./source1012/2018/CVE-2018-10858/freewind%samba/mac-4.8.9/47081d9de813_patch/equal_file_patch/288a79d997.patch,2,8,3,0,0,0,5,0,5,6,0,6,0,0,0,15,0,15,8,0,8,0,0,0,0,0,0,2,1,2,15,4,15
113,./source1012/2018/CVE-2018-13100/torvalds%linux/master/fe6f0ed0dac7_patch/equal_file_patch/b8072d5b3cdd.patch,1,17,1,0,0,0,13,3,10,33,15,18,1,0,1,131,50,81,49,23,26,22,9,13,2,1,1,25,17,23,81,53,77
114,./source1012/2018/CVE-2018-13100/torvalds%linux/master/fe6f0ed0dac7_patch/equal_file_patch/0eac1102e948.patch,1,13,1,0,0,0,18,5,13,25,11,14,1,0,1,108,38,70,46,20,26,23,9,14,2,1,1,19,12,17,62,38,60
115,./source1012/2018/CVE-2018-13100/torvalds%linux/master/fe6f0ed0dac7_patch/equal_file_patch/5664896ba29e.patch,1,13,1,0,0,0,20,6,14,25,11,14,1,0,1,114,40,74,50,22,28,23,9,14,2,1,1,19,12,17,63,38,61
116,./source1012/2018/CVE-2018-13100/torvalds%linux/master/fe6f0ed0dac7_patch/equal_file_patch/fbc246a12aac.patch,1,17,1,0,0,0,10,3,7,32,15,17,0,0,0,123,50,73,47,23,24,21,9,12,2,1,1,23,17,21,69,53,64
117,./source1012/2018/CVE-2018-13100/torvalds%linux/master/fe6f0ed0dac7_patch/equal_file_patch/fe6f0ed0dac7.patch,1,2,1,0,0,0,3,1,2,0,0,0,0,0,0,5,2,3,3,2,1,2,0,2,0,0,0,2,1,1,4,4,4
118,./source1012/2018/CVE-2018-13100/torvalds%linux/master/fe6f0ed0dac7_patch/equal_file_patch/a641a88e5d68.patch,1,16,1,0,0,0,8,2,6,2,0,2,0,0,0,104,49,55,43,21,22,21,9,12,2,1,1,23,17,21,67,52,63
119,./source1012/2018/CVE-2018-16253/igrr%axtls-8266/master/5efe2947ab45_patch/equal_file_patch/5efe2947ab45.patch,1,4,2,1,0,1,10,4,6,4,0,4,2,1,1,24,10,14,12,4,8,4,2,2,2,2,0,4,3,3,22,14,17
120,./source1012/2018/CVE-2018-16253/igrr%axtls-8266/master/5efe2947ab45_patch/equal_file_patch/9ebc3ee.patch,1,4,2,1,0,1,10,4,6,4,0,4,2,1,1,24,10,14,12,4,8,4,2,2,2,2,0,4,3,3,22,14,17
121,./source1012/2018/CVE-2018-20750/LibVNC%libvncserver/feat-readme-buildsystems/ba710eb145bd_patch/equal_file_patch/5aeda75663fe.patch,1,21,1,1,0,1,41,7,34,19,3,16,14,1,13,33,9,24,34,8,26,47,3,44,10,0,10,16,6,13,56,23,53
122,./source1012/2018/CVE-2018-20750/LibVNC%libvncserver/feat-readme-buildsystems/ba710eb145bd_patch/equal_file_patch/127b44ca.patch,1,17,1,0,0,0,37,6,31,18,3,15,12,0,12,32,9,23,30,7,23,43,2,41,9,0,9,13,5,10,39,19,36
123,./source1012/2018/CVE-2018-20750/LibVNC%libvncserver/feat-readme-buildsystems/ba710eb145bd_patch/equal_file_patch/a64c3b37af9a.patch,1,21,1,1,0,1,41,7,34,19,3,16,14,1,13,33,9,24,34,8,26,47,3,44,10,0,10,16,6,13,56,23,53
124,./source1012/2018/CVE-2018-20750/LibVNC%libvncserver/feat-readme-buildsystems/ba710eb145bd_patch/equal_file_patch/78f26fe1ff2a.patch,1,7,1,0,0,0,7,4,3,7,3,4,0,0,0,10,5,5,6,3,3,5,2,3,0,0,0,2,2,1,13,12,6
125,./source1012/2018/CVE-2018-20750/LibVNC%libvncserver/feat-readme-buildsystems/ba710eb145bd_patch/equal_file_patch/c3115350eb8b.patch,1,18,1,0,0,0,38,6,32,18,3,15,14,1,13,32,9,23,32,8,24,44,2,42,9,0,9,13,5,10,39,20,36
126,./source1012/2018/CVE-2018-20750/LibVNC%libvncserver/feat-readme-buildsystems/ba710eb145bd_patch/equal_file_patch/f007b685.patch,1,21,1,1,0,1,41,7,34,19,3,16,14,1,13,33,9,24,34,8,26,47,3,44,10,0,10,16,6,13,56,23,53
127,./source1012/2018/CVE-2018-5121/jemalloc%jemalloc/dev/d9f7b2a4307f7ff9f7a139b33d366d44e8a8b83d_patch/equal_file_patch/b9509349.patch,1,1,1,2,1,1,0,0,0,0,0,0,0,0,0,4,2,2,0,0,0,0,0,0,0,0,0,1,1,1,3,3,3
128,./source1012/2018/CVE-2018-5333/torvalds%linux/master/ef7f8cec80a0_patch/equal_file_patch/ef7f8cec80a0.patch,9,9,1,0,0,0,0,0,0,0,0,0,0,0,0,18,0,18,9,0,9,0,0,0,0,0,0,0,0,0,4,0,4
129,./source1012/2018/CVE-2018-5333/torvalds%linux/master/ef7f8cec80a0_patch/equal_file_patch/c8372665b4b9.patch,9,18,1,0,0,0,18,9,9,0,0,0,0,0,0,72,27,45,36,9,27,9,9,0,0,0,0,4,1,3,8,6,7
130,./source1012/2018/CVE-2018-5333/torvalds%linux/master/ef7f8cec80a0_patch/equal_file_patch/47ec5303d73e.patch,9,18,1,0,0,0,18,9,9,0,0,0,0,0,0,72,27,45,36,9,27,9,9,0,0,0,0,4,1,3,8,6,7
131,./source1012/2018/CVE-2018-5333/torvalds%linux/master/ef7f8cec80a0_patch/equal_file_patch/519be6995c31.patch,9,27,1,0,0,0,18,9,9,0,0,0,0,0,0,90,45,45,45,18,27,18,9,9,9,0,9,1,1,1,8,6,7
132,./source1012/2018/CVE-2018-5333/torvalds%linux/master/ef7f8cec80a0_patch/equal_file_patch/bd2463ac7d7e.patch,9,27,1,0,0,0,18,9,9,0,0,0,0,0,0,90,45,45,45,18,27,18,9,9,9,0,9,1,1,1,8,6,7
133,./source1012/2018/CVE-2018-5333/torvalds%linux/master/ef7f8cec80a0_patch/equal_file_patch/f86d1fbbe785.patch,9,18,1,0,0,0,18,9,9,0,0,0,0,0,0,72,27,45,36,9,27,9,9,0,0,0,0,4,1,3,8,6,7
134,./source1012/2018/CVE-2018-5995/torvalds%linux/master/da6af54dc001_patch/equal_file_patch/a111daf0c53a.patch,1,12,1,0,0,0,29,20,9,35,18,17,3,2,1,34,32,2,13,13,0,14,10,4,4,4,0,33,21,17,56,48,15
135,./source1012/2018/CVE-2018-5995/torvalds%linux/master/da6af54dc001_patch/equal_file_patch/0af5cb349a2c.patch,1,12,1,0,0,0,29,20,9,35,18,17,3,2,1,34,32,2,13,13,0,14,10,4,4,4,0,33,21,17,56,48,15
136,./source1012/2018/CVE-2018-8459/sagarpant1%ChakraCore/master/e2ae5db9b79d_patch/equal_file_patch/8527dc23954b.patch,3,15,4,1,1,0,7,3,4,2,0,2,1,1,0,30,7,23,10,2,8,6,2,4,0,0,0,9,4,6,68,31,47
137,./source1012/2018/CVE-2018-8459/sagarpant1%ChakraCore/master/e2ae5db9b79d_patch/equal_file_patch/e2ae5db9b79d.patch,5,29,8,0,0,0,7,0,7,1,0,1,1,0,1,46,5,41,19,4,15,2,0,2,0,0,0,11,5,11,61,12,61
138,./source1012/2018/CVE-2018-8459/sagarpant1%ChakraCore/master/e2ae5db9b79d_patch/equal_file_patch/f24008eba249.patch,1,2,1,1,1,0,6,3,3,2,0,2,1,1,0,20,7,13,2,2,0,6,2,4,0,0,0,4,3,1,61,30,40
139,./source1012/2018/CVE-2018-8459/sagarpant1%ChakraCore/master/e2ae5db9b79d_patch/equal_file_patch/9976ab20ed44.patch,1,1,1,0,0,0,2,0,2,1,0,1,0,0,0,2,0,2,0,0,0,1,0,1,0,0,0,0,0,0,14,0,14
140,./source1012/2018/CVE-2018-8459/sagarpant1%ChakraCore/master/e2ae5db9b79d_patch/equal_file_patch/95b7191c299e.patch,2,18,5,1,1,0,15,5,10,2,0,2,2,1,1,57,13,44,15,7,8,10,3,7,3,1,2,13,9,10,101,43,84
141,./source1012/2018/CVE-2018-8459/sagarpant1%ChakraCore/master/e2ae5db9b79d_patch/equal_file_patch/95b7191c2.patch,6,51,15,9,3,6,43,7,36,6,1,5,10,1,9,201,26,175,73,10,63,46,9,37,4,1,3,50,12,47,302,76,290
142,./source1012/2019/CVE-2019-0539/sagarpant1%ChakraCore/master/2dfc7ab48da1_patch/equal_file_patch/dd6f5ce0c.patch,1,1,1,0,0,0,4,0,4,1,0,1,0,0,0,1,0,1,1,0,1,1,0,1,0,0,0,1,0,1,7,0,7
143,./source1012/2019/CVE-2019-0539/sagarpant1%ChakraCore/master/2dfc7ab48da1_patch/equal_file_patch/b5e4874c6bc5.patch,1,14,1,2,0,2,73,11,62,5,0,5,3,1,2,93,18,75,73,20,53,19,6,13,0,0,0,11,6,11,124,34,124
144,./source1012/2019/CVE-2019-0539/sagarpant1%ChakraCore/master/2dfc7ab48da1_patch/equal_file_patch/2751a8635f69.patch,1,14,1,0,0,0,66,11,55,4,0,4,3,1,2,69,18,51,45,20,25,16,6,10,0,0,0,9,6,9,116,34,116
145,./source1012/2019/CVE-2019-0539/sagarpant1%ChakraCore/master/2dfc7ab48da1_patch/equal_file_patch/95b7191c299e.patch,1,5,1,0,0,0,40,10,30,3,0,3,2,1,1,29,10,19,17,12,5,11,6,5,0,0,0,4,3,4,75,31,75
146,./source1012/2019/CVE-2019-0539/sagarpant1%ChakraCore/master/2dfc7ab48da1_patch/equal_file_patch/f41c0d038.patch,1,1,1,0,0,0,4,0,4,1,0,1,0,0,0,1,0,1,1,0,1,1,0,1,0,0,0,1,0,1,7,0,7
147,./source1012/2019/CVE-2019-0539/sagarpant1%ChakraCore/master/2dfc7ab48da1_patch/equal_file_patch/c60faa4e2.patch,1,11,1,0,0,0,65,11,54,4,0,4,3,1,2,53,11,42,29,13,16,16,6,10,0,0,0,6,3,6,114,31,114
148,./source1012/2019/CVE-2019-10746/jonschlinkert%mixin-deep/master/8f464c8ce976_patch/equal_file_patch/8f464c8ce976.patch,0,0,0,0,0,0,0,0,0,0,0,0,0,0,0,0,0,0,0,0,0,0,0,0,0,0,0,0,0,0,0,0,0
149,./source1012/2019/CVE-2019-10746/jonschlinkert%mixin-deep/master/8f464c8ce976_patch/equal_file_patch/9166566.patch,0,0,0,0,0,0,0,0,0,0,0,0,0,0,0,0,0,0,0,0,0,0,0,0,0,0,0,0,0,0,0,0,0
150,./source1012/2019/CVE-2019-11016/Elgg%Elgg/3.1/1b24ec49572d_patch/equal_file_patch/6b8fc14e0.patch,0,0,0,0,0,0,0,0,0,0,0,0,0,0,0,0,0,0,0,0,0,0,0,0,0,0,0,0,0,0,0,0,0
151,./source1012/2019/CVE-2019-11016/Elgg%Elgg/3.1/1b24ec49572d_patch/equal_file_patch/b5806448d.patch,0,0,0,0,0,0,0,0,0,0,0,0,0,0,0,0,0,0,0,0,0,0,0,0,0,0,0,0,0,0,0,0,0
152,./source1012/2019/CVE-2019-11016/Elgg%Elgg/3.1/1b24ec49572d_patch/equal_file_patch/fd3778d4c.patch,0,0,0,0,0,0,0,0,0,0,0,0,0,0,0,0,0,0,0,0,0,0,0,0,0,0,0,0,0,0,0,0,0
153,./source1012/2019/CVE-2019-11016/Elgg%Elgg/3.1/1b24ec49572d_patch/equal_file_patch/d839f99a9.patch,0,0,0,0,0,0,0,0,0,0,0,0,0,0,0,0,0,0,0,0,0,0,0,0,0,0,0,0,0,0,0,0,0
154,./source1012/2019/CVE-2019-11016/Elgg%Elgg/3.1/1b24ec49572d_patch/equal_file_patch/d78957c13.patch,0,0,0,0,0,0,0,0,0,0,0,0,0,0,0,0,0,0,0,0,0,0,0,0,0,0,0,0,0,0,0,0,0
155,./source1012/2019/CVE-2019-11016/Elgg%Elgg/3.1/1b24ec49572d_patch/equal_file_patch/21fb586c3.patch,0,0,0,0,0,0,0,0,0,0,0,0,0,0,0,0,0,0,0,0,0,0,0,0,0,0,0,0,0,0,0,0,0
156,./source1012/2019/CVE-2019-11038/libgd%libgd/GD-2.3/e13a342c079a_patch/equal_file_patch/e13a342c079a.patch,1,1,1,0,0,0,1,0,1,1,0,1,0,0,0,2,1,1,1,0,1,1,0,1,2,1,1,3,1,3,8,3,8
157,./source1012/2019/CVE-2019-11038/libgd%libgd/GD-2.3/e13a342c079a_patch/equal_file_patch/6d21d304.patch,1,1,1,0,0,0,1,0,1,1,0,1,0,0,0,2,1,1,1,0,1,1,0,1,2,1,1,3,1,3,8,3,8
158,./source1012/2019/CVE-2019-11038/libgd%libgd/GD-2.3/e13a342c079a_patch/equal_file_patch/7cb597af.patch,1,1,1,0,0,0,1,0,1,1,0,1,0,0,0,2,1,1,1,0,1,1,0,1,2,1,1,3,1,3,8,3,8
159,./source1012/2019/CVE-2019-11038/libgd%libgd/GD-2.3/e13a342c079a_patch/equal_file_patch/3eff74e8.patch,1,1,1,0,0,0,1,0,1,1,0,1,0,0,0,2,1,1,1,0,1,1,0,1,2,1,1,3,1,3,8,3,8
160,./source1012/2019/CVE-2019-11038/libgd%libgd/GD-2.3/e13a342c079a_patch/equal_file_patch/7d900424.patch,1,1,1,0,0,0,1,0,1,1,0,1,0,0,0,2,1,1,1,0,1,1,0,1,2,1,1,3,1,3,8,3,8
161,./source1012/2019/CVE-2019-11038/libgd%libgd/GD-2.3/e13a342c079a_patch/equal_file_patch/0be6aec0.patch,1,1,1,0,0,0,1,0,1,1,0,1,0,0,0,2,1,1,1,0,1,1,0,1,2,1,1,3,1,3,8,3,8
162,./source1012/2019/CVE-2019-11038/mejo-%libgd/fix_github_501/c76ed17aee1f_patch/equal_file_patch/c76ed17aee1f.patch,1,1,1,0,0,0,1,0,1,1,0,1,0,0,0,2,1,1,1,0,1,1,0,1,2,1,1,3,1,3,8,3,8
163,./source1012/2019/CVE-2019-13147/antlarr%audiofile/master/c48e4c6503f7_patch/equal_file_patch/c48e4c6503f7.patch,1,1,1,0,0,0,2,0,2,1,0,1,0,0,0,0,0,0,2,0,2,2,0,2,0,0,0,1,0,1,9,0,9
164,./source1012/2019/CVE-2019-13147/antlarr%audiofile/master/c48e4c6503f7_patch/equal_file_patch/7d65f89.patch,1,1,1,0,0,0,2,0,2,1,0,1,0,0,0,0,0,0,2,0,2,2,0,2,0,0,0,1,0,1,9,0,9
165,./source1012/2019/CVE-2019-13225/kkos%oniguruma/master/c509265c5f6a_patch/equal_file_patch/d655d93.patch,1,22,2,0,0,0,23,8,15,4,1,3,0,0,0,131,64,67,28,13,15,0,0,0,0,0,0,7,6,6,51,34,35
166,./source1012/2019/CVE-2019-13225/kkos%oniguruma/master/c509265c5f6a_patch/equal_file_patch/99277c196abf.patch,1,23,2,0,0,0,19,6,13,4,1,3,0,0,0,103,50,53,12,5,7,0,0,0,0,0,0,6,5,5,45,30,31
167,./source1012/2019/CVE-2019-13225/kkos%oniguruma/master/c509265c5f6a_patch/equal_file_patch/1278d05e11c4.patch,1,28,2,0,0,0,23,8,15,4,1,3,0,0,0,152,76,76,32,15,17,0,0,0,0,0,0,10,9,8,57,39,38
168,./source1012/2019/CVE-2019-13225/kkos%oniguruma/master/c509265c5f6a_patch/equal_file_patch/9793f389a93c.patch,1,36,2,0,0,0,24,8,16,5,1,4,0,0,0,181,81,100,43,15,28,3,0,3,0,0,0,11,9,9,70,42,48
169,./source1012/2019/CVE-2019-13225/kkos%oniguruma/master/c509265c5f6a_patch/equal_file_patch/2b36133.patch,1,22,2,0,0,0,23,8,15,4,1,3,0,0,0,131,64,67,28,13,15,0,0,0,0,0,0,7,6,6,51,34,35
170,./source1012/2019/CVE-2019-13225/kkos%oniguruma/master/c509265c5f6a_patch/equal_file_patch/f76abc911a12.patch,1,22,2,0,0,0,23,8,15,4,1,3,0,0,0,131,64,67,28,13,15,0,0,0,0,0,0,7,6,6,51,34,35
171,./source1012/2019/CVE-2019-13227/linuxdeepin%deepin-clone/master/a0374eeea860_patch/equal_file_patch/e59182b9c229.patch,4,25,6,0,0,0,9,5,4,3,2,1,0,0,0,266,143,123,37,19,18,12,6,6,12,6,6,18,16,16,60,58,58
172,./source1012/2019/CVE-2019-13227/linuxdeepin%deepin-clone/master/a0374eeea860_patch/equal_file_patch/8c7a7b247e0b.patch,4,110,17,4,2,2,32,12,20,28,12,16,0,0,0,426,222,204,72,36,36,88,42,46,126,56,70,21,14,20,96,87,95
173,./source1012/2019/CVE-2019-13227/linuxdeepin%deepin-clone/master/a0374eeea860_patch/equal_file_patch/643e903048be.patch,3,27,1,0,0,0,42,18,24,0,0,0,0,0,0,276,150,126,36,18,18,0,0,0,0,0,0,4,4,2,26,24,24
174,./source1012/2019/CVE-2019-13227/linuxdeepin%deepin-clone/master/a0374eeea860_patch/equal_file_patch/37588ccbb59c.patch,1,1,1,0,0,0,0,0,0,0,0,0,0,0,0,2,1,1,0,0,0,0,0,0,2,1,1,1,1,1,6,6,6
175,./source1012/2019/CVE-2019-13227/linuxdeepin%deepin-clone/master/a0374eeea860_patch/equal_file_patch/b8ea9d5bd708.patch,4,100,17,4,2,2,32,12,20,28,12,16,0,0,0,394,204,190,48,24,24,88,42,46,90,38,52,20,13,19,88,79,87
176,./source1012/2019/CVE-2019-13227/linuxdeepin%deepin-clone/master/a0374eeea860_patch/equal_file_patch/6ce112cce473.patch,4,110,17,4,2,2,32,12,20,28,12,16,0,0,0,426,222,204,72,36,36,88,42,46,126,56,70,21,14,20,96,87,95
177,./source1012/2019/CVE-2019-13227/linuxdeepin%deepin-clone/master/e079f3e2712b_patch/equal_file_patch/01491567316a.patch,14,218,24,8,4,4,112,52,60,30,14,16,4,2,2,1304,680,624,194,100,94,148,80,68,158,76,82,53,42,35,175,158,157
178,./source1012/2019/CVE-2019-13227/linuxdeepin%deepin-clone/master/e079f3e2712b_patch/equal_file_patch/f23e3cb6f0a1.patch,2,26,1,4,2,2,18,12,6,2,2,0,4,2,2,58,32,26,24,14,10,20,12,8,6,4,2,30,24,13,48,35,28
179,./source1012/2019/CVE-2019-13227/linuxdeepin%deepin-clone/master/e079f3e2712b_patch/equal_file_patch/37588ccbb59c.patch,2,20,1,4,2,2,16,12,4,2,2,0,4,2,2,56,30,26,20,12,8,20,12,8,4,4,0,26,22,11,38,32,20
180,./source1012/2019/CVE-2019-13227/linuxdeepin%deepin-clone/master/e079f3e2712b_patch/equal_file_patch/216a9c00a794.patch,14,226,25,8,4,4,120,56,64,36,18,18,4,2,2,1304,680,624,198,102,96,148,80,68,160,76,84,55,42,39,182,158,165
181,./source1012/2019/CVE-2019-13227/linuxdeepin%deepin-clone/master/e079f3e2712b_patch/equal_file_patch/e59182b9c229.patch,4,32,5,0,0,0,14,8,6,6,4,2,0,0,0,332,174,158,50,26,24,16,8,8,20,10,10,14,12,12,46,43,43
182,./source1012/2019/CVE-2019-13227/linuxdeepin%deepin-clone/master/e079f3e2712b_patch/equal_file_patch/06e64a1c865b.patch,4,48,1,0,0,0,56,24,32,0,0,0,0,0,0,448,248,200,48,24,24,12,12,0,4,4,0,8,8,3,44,40,36
183,./source1012/2019/CVE-2019-14615/torvalds%linux/master/63d264fe0868_patch/equal_file_patch/477f70cd2a67.patch,1,4,1,0,0,0,0,0,0,1,1,0,2,2,0,14,10,4,3,2,1,1,1,0,3,0,3,5,4,3,17,12,11
184,./source1012/2019/CVE-2019-14615/torvalds%linux/master/63d264fe0868_patch/equal_file_patch/e058a84bfddc.patch,1,1,1,0,0,0,0,0,0,0,0,0,0,0,0,1,0,1,0,0,0,0,0,0,3,0,3,1,0,1,6,0,6
185,./source1012/2019/CVE-2019-14615/torvalds%linux/master/63d264fe0868_patch/equal_file_patch/63d264fe0868.patch,1,1,1,0,0,0,0,0,0,0,0,0,0,0,0,1,0,1,0,0,0,0,0,0,3,0,3,1,0,1,6,0,6
186,./source1012/2019/CVE-2019-15666/torvalds%linux/master/82463436a7fa_patch/equal_file_patch/5627ecb8374a.patch,1,11,3,0,0,0,20,5,15,7,0,7,4,1,3,82,15,67,37,5,32,9,1,8,20,5,15,16,3,14,74,32,68
187,./source1012/2019/CVE-2019-15666/torvalds%linux/master/82463436a7fa_patch/equal_file_patch/a111daf0c53a.patch,1,11,3,0,0,0,20,5,15,7,0,7,4,1,3,82,15,67,37,5,32,9,1,8,20,5,15,16,3,14,74,32,68
188,./source1012/2019/CVE-2019-15666/torvalds%linux/master/82463436a7fa_patch/equal_file_patch/351c8a09b00b.patch,1,1,1,0,0,0,2,1,1,0,0,0,2,1,1,5,3,2,4,2,2,1,1,0,0,0,0,2,1,1,8,7,4
189,./source1012/2019/CVE-2019-15666/torvalds%linux/master/82463436a7fa_patch/equal_file_patch/5c8db3eb3817.patch,1,1,1,0,0,0,2,1,1,0,0,0,2,1,1,5,3,2,4,2,2,1,1,0,0,0,0,2,1,1,8,7,4
190,./source1012/2019/CVE-2019-15666/torvalds%linux/master/82463436a7fa_patch/equal_file_patch/b90e90f40b4f.patch,1,11,3,0,0,0,21,5,16,8,0,8,5,1,4,82,13,69,39,5,34,9,1,8,20,5,15,17,3,15,75,30,71
191,./source1012/2019/CVE-2019-15666/torvalds%linux/master/82463436a7fa_patch/equal_file_patch/12a0cf7241f9.patch,1,11,3,0,0,0,9,5,4,0,0,0,2,1,1,34,13,21,20,5,15,1,1,0,12,5,7,7,3,4,34,30,30
192,./source1012/2019/CVE-2019-15902/torvalds%linux/master/caf9a82657b3_patch/equal_file_patch/0af5cb349a2c.patch,4,8,2,0,0,0,0,0,0,0,0,0,0,0,0,38,14,24,12,6,6,0,0,0,10,4,6,2,1,2,18,12,17
193,./source1012/2019/CVE-2019-15902/torvalds%linux/master/caf9a82657b3_patch/equal_file_patch/a111daf0c53a.patch,4,8,2,0,0,0,0,0,0,0,0,0,0,0,0,38,14,24,12,6,6,0,0,0,10,4,6,2,1,2,18,12,17
194,./source1012/2019/CVE-2019-16713/ImageMagick%ImageMagick/main/371f49ba1d64_patch/equal_file_patch/4cd61940e.patch,1,8,1,0,0,0,3,0,3,7,3,4,0,0,0,19,8,11,12,5,7,8,2,6,0,0,0,7,3,7,21,14,19
195,./source1012/2019/CVE-2019-16713/ImageMagick%ImageMagick/main/371f49ba1d64_patch/equal_file_patch/3ba61dc26.patch,1,10,1,0,0,0,3,0,3,9,4,5,0,0,0,22,9,13,13,5,8,8,2,6,0,0,0,9,3,9,21,14,19
196,./source1012/2019/CVE-2019-16713/ImageMagick%ImageMagick/main/371f49ba1d64_patch/equal_file_patch/d6bf4c260.patch,1,8,1,0,0,0,3,0,3,7,3,4,0,0,0,19,8,11,12,5,7,8,2,6,0,0,0,7,3,7,21,14,19
197,./source1012/2019/CVE-2019-16713/ImageMagick%ImageMagick/main/371f49ba1d64_patch/equal_file_patch/5a1498034.patch,1,10,1,0,0,0,3,0,3,9,4,5,0,0,0,22,9,13,13,5,8,8,2,6,0,0,0,9,3,9,21,14,19
198,./source1012/2019/CVE-2019-16713/ImageMagick%ImageMagick/main/371f49ba1d64_patch/equal_file_patch/f2b6ffa40.patch,1,8,1,0,0,0,3,0,3,7,3,4,0,0,0,19,8,11,12,5,7,8,2,6,0,0,0,7,3,7,21,14,19
199,./source1012/2019/CVE-2019-16713/ImageMagick%ImageMagick/main/371f49ba1d64_patch/equal_file_patch/80c5cc272.patch,1,8,1,0,0,0,3,0,3,7,3,4,0,0,0,19,8,11,12,5,7,8,2,6,0,0,0,7,3,7,21,14,19
200,./source1012/2019/CVE-2019-16884/wuka1%docker_19.03/main/3fec3d1f1cf4_patch/equal_file_patch/77e06fda0.patch,2,6,1,4,4,0,4,4,0,0,0,0,0,0,0,0,0,0,2,2,0,2,2,0,2,2,0,5,3,2,13,10,3
201,./source1012/2019/CVE-2019-16884/wuka1%docker_19.03/main/3fec3d1f1cf4_patch/equal_file_patch/aa98b4f5d.patch,2,6,1,4,4,0,4,4,0,0,0,0,0,0,0,0,0,0,2,2,0,2,2,0,2,2,0,5,3,2,13,10,3
202,./source1012/2019/CVE-2019-16884/wuka1%docker_19.03/main/3fec3d1f1cf4_patch/equal_file_patch/e686f468f.patch,2,6,1,4,4,0,4,4,0,0,0,0,0,0,0,0,0,0,2,2,0,2,2,0,2,2,0,5,3,2,13,10,3
203,./source1012/2019/CVE-2019-16884/wuka1%docker_19.03/main/3fec3d1f1cf4_patch/equal_file_patch/3fec3d1f1cf4.patch,2,6,1,4,4,0,4,4,0,0,0,0,0,0,0,0,0,0,2,2,0,2,2,0,2,2,0,5,3,2,13,10,3
204,./source1012/2019/CVE-2019-16884/wuka1%docker_19.03/main/3fec3d1f1cf4_patch/equal_file_patch/5d5083a57.patch,2,6,1,4,4,0,4,4,0,0,0,0,0,0,0,0,0,0,2,2,0,2,2,0,2,2,0,5,3,2,13,10,3
205,./source1012/2019/CVE-2019-16884/wuka1%docker_19.03/main/3fec3d1f1cf4_patch/equal_file_patch/c4c6cf6b6.patch,2,6,1,4,4,0,4,4,0,0,0,0,0,0,0,0,0,0,2,2,0,2,2,0,2,2,0,5,3,2,13,10,3
206,./source1012/2019/CVE-2019-16884/Hack033%Docker/master/17e1ab174cc5_patch/equal_file_patch/7f96a9a35b.patch,2,6,1,4,4,0,4,4,0,0,0,0,0,0,0,0,0,0,2,2,0,2,2,0,2,2,0,5,3,2,13,10,3
207,./source1012/2019/CVE-2019-16884/Hack033%Docker/master/17e1ab174cc5_patch/equal_file_patch/098144291d.patch,2,6,1,4,4,0,4,4,0,0,0,0,0,0,0,0,0,0,2,2,0,2,2,0,2,2,0,5,3,2,13,10,3
208,./source1012/2019/CVE-2019-16884/Hack033%Docker/master/17e1ab174cc5_patch/equal_file_patch/f9d136b6c6.patch,2,6,1,4,4,0,4,4,0,0,0,0,0,0,0,0,0,0,2,2,0,2,2,0,2,2,0,5,3,2,13,10,3
209,./source1012/2019/CVE-2019-16884/Hack033%Docker/master/17e1ab174cc5_patch/equal_file_patch/ea2f17e7f4.patch,2,8,1,4,4,0,4,4,0,0,0,0,0,0,0,4,2,2,2,2,0,6,4,2,2,2,0,6,4,3,17,14,8
210,./source1012/2019/CVE-2019-16884/Hack033%Docker/master/17e1ab174cc5_patch/equal_file_patch/87c2e65259.patch,2,6,1,4,4,0,4,4,0,0,0,0,0,0,0,0,0,0,2,2,0,2,2,0,2,2,0,5,3,2,13,10,3
211,./source1012/2019/CVE-2019-16884/Hack033%Docker/master/17e1ab174cc5_patch/equal_file_patch/f99814d749.patch,2,8,1,4,4,0,4,4,0,0,0,0,0,0,0,4,2,2,2,2,0,6,4,2,2,2,0,6,4,3,17,14,8
212,./source1012/2019/CVE-2019-18198/torvalds%linux/master/02dc96ef6c25_patch/equal_file_patch/8efd0d9c316a.patch,1,2,1,0,0,0,0,0,0,0,0,0,0,0,0,4,2,2,0,0,0,0,0,0,0,0,0,3,2,2,7,6,7
213,./source1012/2019/CVE-2019-18198/torvalds%linux/master/02dc96ef6c25_patch/equal_file_patch/a111daf0c53a.patch,1,2,1,0,0,0,0,0,0,0,0,0,0,0,0,4,2,2,0,0,0,0,0,0,0,0,0,3,2,2,7,6,7
214,./source1012/2019/CVE-2019-18198/torvalds%linux/master/02dc96ef6c25_patch/equal_file_patch/02dc96ef6c25.patch,1,1,1,0,0,0,1,0,1,0,0,0,0,0,0,1,0,1,1,0,1,1,0,1,1,0,1,1,1,1,4,1,4
215,./source1012/2019/CVE-2019-18198/torvalds%linux/master/02dc96ef6c25_patch/equal_file_patch/386403a115f9.patch,1,1,1,0,0,0,1,0,1,0,0,0,0,0,0,1,0,1,1,0,1,1,0,1,1,0,1,1,1,1,4,1,4
216,./source1012/2019/CVE-2019-18198/torvalds%linux/master/02dc96ef6c25_patch/equal_file_patch/0af5cb349a2c.patch,1,2,1,0,0,0,0,0,0,0,0,0,0,0,0,4,2,2,0,0,0,0,0,0,0,0,0,3,2,2,7,6,7
217,./source1012/2019/CVE-2019-18198/torvalds%linux/master/02dc96ef6c25_patch/equal_file_patch/a51e3ac43ddb.patch,1,2,1,0,0,0,0,0,0,0,0,0,0,0,0,4,2,2,0,0,0,0,0,0,0,0,0,3,2,2,7,6,7
218,./source1012/2019/CVE-2019-18217/proftpd%proftpd/master/51b9f9bb6c6d_patch/equal_file_patch/7a6a77738.patch,2,1,1,0,0,0,0,0,0,0,0,0,0,0,0,1,0,1,0,0,0,0,0,0,0,0,0,0,0,0,2,0,2
219,./source1012/2019/CVE-2019-18217/proftpd%proftpd/master/51b9f9bb6c6d_patch/equal_file_patch/c72fb53ab.patch,2,17,8,0,0,0,28,15,13,12,6,6,0,0,0,46,22,24,43,17,26,33,22,11,0,0,0,0,0,0,29,26,28
220,./source1012/2019/CVE-2019-18217/proftpd%proftpd/master/51b9f9bb6c6d_patch/equal_file_patch/0e68a6cbc.patch,2,17,8,0,0,0,28,15,13,12,6,6,0,0,0,46,22,24,43,17,26,33,22,11,0,0,0,0,0,0,29,26,28
221,./source1012/2019/CVE-2019-18217/proftpd%proftpd/master/51b9f9bb6c6d_patch/equal_file_patch/678696c8d.patch,2,1,1,0,0,0,0,0,0,0,0,0,0,0,0,1,0,1,0,0,0,0,0,0,0,0,0,0,0,0,2,0,2
222,./source1012/2019/CVE-2019-18217/proftpd%proftpd/master/51b9f9bb6c6d_patch/equal_file_patch/af41789dd.patch,2,1,1,0,0,0,0,0,0,0,0,0,0,0,0,1,0,1,0,0,0,0,0,0,0,0,0,0,0,0,2,0,2
223,./source1012/2019/CVE-2019-18217/proftpd%proftpd/master/51b9f9bb6c6d_patch/equal_file_patch/b6b6b443a.patch,2,15,7,0,0,0,28,15,13,10,5,5,0,0,0,42,20,22,41,16,25,33,22,11,0,0,0,0,0,0,26,24,25
224,./source1012/2019/CVE-2019-19060/torvalds%linux/master/9cbc63485fd5_patch/equal_file_patch/4c6ef3b156c6.patch,1,5,2,2,0,2,4,2,2,0,0,0,0,0,0,20,6,14,15,5,10,4,2,2,0,0,0,1,0,1,12,7,11
225,./source1012/2019/CVE-2019-19060/torvalds%linux/master/9cbc63485fd5_patch/equal_file_patch/7ba31c3f2f1e.patch,1,4,2,2,0,2,4,2,2,0,0,0,0,0,0,10,2,8,8,2,6,4,2,2,0,0,0,1,0,1,4,2,4
226,./source1012/2019/CVE-2019-19060/torvalds%linux/master/9cbc63485fd5_patch/equal_file_patch/02e2af20f4f9.patch,1,6,2,1,0,1,5,3,2,0,0,0,0,0,0,22,9,13,16,7,9,3,2,1,0,0,0,3,1,2,18,11,15
227,./source1012/2019/CVE-2019-19060/torvalds%linux/master/9cbc63485fd5_patch/equal_file_patch/ade7afe3e606.patch,1,9,2,5,2,3,9,4,5,0,0,0,0,0,0,62,26,36,38,15,23,5,3,2,0,0,0,3,2,3,29,19,21
228,./source1012/2019/CVE-2019-19060/torvalds%linux/master/9cbc63485fd5_patch/equal_file_patch/a16d8644bad4.patch,1,11,2,5,2,3,11,4,7,0,0,0,0,0,0,74,26,48,48,15,33,5,3,2,0,0,0,3,2,3,31,19,24
229,./source1012/2019/CVE-2019-19060/torvalds%linux/master/9cbc63485fd5_patch/equal_file_patch/9cbc63485fd5.patch,1,4,2,2,0,2,4,2,2,0,0,0,0,0,0,10,2,8,8,2,6,4,2,2,0,0,0,1,0,1,4,2,4
230,./source1012/2019/CVE-2019-19062/torvalds%linux/master/642356cb5f4a_patch/equal_file_patch/a78208e24369.patch,1,2,1,1,0,1,2,1,1,0,0,0,0,0,0,0,0,0,0,0,0,0,0,0,0,0,0,1,0,1,2,1,2
231,./source1012/2019/CVE-2019-19062/torvalds%linux/master/642356cb5f4a_patch/equal_file_patch/0af5cb349a2c.patch,1,2,1,1,0,1,2,1,1,0,0,0,0,0,0,0,0,0,0,0,0,0,0,0,0,0,0,1,0,1,2,1,2
232,./source1012/2019/CVE-2019-19062/torvalds%linux/master/642356cb5f4a_patch/equal_file_patch/642356cb5f4a.patch,1,2,1,1,0,1,2,1,1,0,0,0,0,0,0,0,0,0,0,0,0,0,0,0,0,0,0,1,0,1,2,1,2
233,./source1012/2019/CVE-2019-19062/torvalds%linux/master/642356cb5f4a_patch/equal_file_patch/a111daf0c53a.patch,1,2,1,1,0,1,2,1,1,0,0,0,0,0,0,0,0,0,0,0,0,0,0,0,0,0,0,1,0,1,2,1,2
234,./source1012/2019/CVE-2019-19062/insilications%linux/master/bf38d57e3ade_patch/equal_file_patch/7023045dc495.patch,0,0,0,0,0,0,0,0,0,0,0,0,0,0,0,0,0,0,0,0,0,0,0,0,0,0,0,0,0,0,0,0,0
235,./source1012/2019/CVE-2019-19062/insilications%linux/master/bf38d57e3ade_patch/equal_file_patch/9b668be4aaa1.patch,0,0,0,0,0,0,0,0,0,0,0,0,0,0,0,0,0,0,0,0,0,0,0,0,0,0,0,0,0,0,0,0,0
236,./source1012/2019/CVE-2019-19062/insilications%linux/master/bf38d57e3ade_patch/equal_file_patch/c5c9f4871b6c.patch,0,0,0,0,0,0,0,0,0,0,0,0,0,0,0,0,0,0,0,0,0,0,0,0,0,0,0,0,0,0,0,0,0
237,./source1012/2019/CVE-2019-19062/insilications%linux/master/bf38d57e3ade_patch/equal_file_patch/8cd9bbf0ab32.patch,0,0,0,0,0,0,0,0,0,0,0,0,0,0,0,0,0,0,0,0,0,0,0,0,0,0,0,0,0,0,0,0,0
238,./source1012/2019/CVE-2019-19062/insilications%linux/master/bf38d57e3ade_patch/equal_file_patch/69e447524015.patch,0,0,0,0,0,0,0,0,0,0,0,0,0,0,0,0,0,0,0,0,0,0,0,0,0,0,0,0,0,0,0,0,0
239,./source1012/2019/CVE-2019-19062/insilications%linux/master/bf38d57e3ade_patch/equal_file_patch/26faa0c4c2a8.patch,0,0,0,0,0,0,0,0,0,0,0,0,0,0,0,0,0,0,0,0,0,0,0,0,0,0,0,0,0,0,0,0,0
240,./source1012/2019/CVE-2019-19080/torvalds%linux/master/02dc96ef6c25_patch/equal_file_patch/02dc96ef6c25.patch,1,4,1,4,0,4,0,0,0,0,0,0,0,0,0,0,0,0,0,0,0,0,0,0,0,0,0,2,0,2,2,0,2
241,./source1012/2019/CVE-2019-19080/torvalds%linux/master/02dc96ef6c25_patch/equal_file_patch/4a21185cda0f.patch,1,4,1,4,0,4,0,0,0,0,0,0,0,0,0,0,0,0,0,0,0,0,0,0,0,0,0,2,0,2,2,0,2
242,./source1012/2019/CVE-2019-19080/torvalds%linux/master/02dc96ef6c25_patch/equal_file_patch/169e77764adc.patch,1,4,1,4,0,4,0,0,0,0,0,0,0,0,0,0,0,0,0,0,0,0,0,0,0,0,0,2,0,2,2,0,2
243,./source1012/2019/CVE-2019-19080/torvalds%linux/master/02dc96ef6c25_patch/equal_file_patch/a111daf0c53a.patch,1,4,1,4,0,4,0,0,0,0,0,0,0,0,0,0,0,0,0,0,0,0,0,0,0,0,0,2,0,2,2,0,2
244,./source1012/2019/CVE-2019-19080/torvalds%linux/master/02dc96ef6c25_patch/equal_file_patch/0af5cb349a2c.patch,1,4,1,4,0,4,0,0,0,0,0,0,0,0,0,0,0,0,0,0,0,0,0,0,0,0,0,2,0,2,2,0,2
245,./source1012/2019/CVE-2019-19080/torvalds%linux/master/02dc96ef6c25_patch/equal_file_patch/cb8e59cc8720.patch,1,4,1,4,0,4,0,0,0,0,0,0,0,0,0,0,0,0,0,0,0,0,0,0,0,0,0,2,0,2,2,0,2
246,./source1012/2019/CVE-2019-19080/torvalds%linux/master/f6705bf959ef_patch/equal_file_patch/9f68e3655aae.patch,1,12,1,0,0,0,16,0,16,0,0,0,0,0,0,0,0,0,0,0,0,4,0,4,84,40,44,3,1,2,19,16,18
247,./source1012/2019/CVE-2019-19080/torvalds%linux/master/f6705bf959ef_patch/equal_file_patch/4971f090aa7f.patch,1,12,1,0,0,0,20,0,20,0,0,0,0,0,0,2,0,2,2,0,2,4,0,4,86,40,46,3,1,2,22,16,21
248,./source1012/2019/CVE-2019-19080/torvalds%linux/master/f6705bf959ef_patch/equal_file_patch/be8454afc50f.patch,1,12,1,0,0,0,16,0,16,0,0,0,0,0,0,0,0,0,0,0,0,4,0,4,84,40,44,3,1,2,19,16,18
249,./source1012/2019/CVE-2019-19080/torvalds%linux/master/f6705bf959ef_patch/equal_file_patch/5dc9cbc4f10d.patch,1,4,1,0,0,0,16,0,16,0,0,0,0,0,0,0,0,0,0,0,0,4,0,4,4,0,4,2,0,2,2,0,2
250,./source1012/2019/CVE-2019-19080/torvalds%linux/master/f6705bf959ef_patch/equal_file_patch/a6ed68d6468b.patch,1,12,1,0,0,0,16,0,16,0,0,0,0,0,0,0,0,0,0,0,0,4,0,4,84,40,44,3,1,2,19,16,18
251,./source1012/2019/CVE-2019-19080/torvalds%linux/master/f6705bf959ef_patch/equal_file_patch/c3bed3b20e40.patch,1,12,1,0,0,0,16,0,16,0,0,0,0,0,0,0,0,0,0,0,0,4,0,4,84,40,44,3,1,2,19,16,18
252,./source1012/2019/CVE-2019-19274/python%cpython/3.7/a4d78362397fc3bced6ea80fbc7b5f4827aec55e_patch/equal_file_patch/64be96ae1f.patch,11,495,73,25,13,12,547,441,106,409,296,113,96,59,37,1811,1283,528,1080,795,285,618,448,170,229,173,56,115,101,73,573,483,313
253,./source1012/2019/CVE-2019-19274/python%cpython/3.7/a4d78362397fc3bced6ea80fbc7b5f4827aec55e_patch/equal_file_patch/15d263e95c.patch,10,494,72,25,13,12,547,441,106,409,296,113,96,59,37,1807,1282,525,1079,795,284,618,448,170,229,173,56,115,101,73,572,483,312
254,./source1012/2019/CVE-2019-19274/python%cpython/3.7/a4d78362397fc3bced6ea80fbc7b5f4827aec55e_patch/equal_file_patch/65e187239a.patch,10,494,72,25,13,12,547,441,106,409,296,113,96,59,37,1807,1282,525,1079,795,284,618,448,170,229,173,56,115,101,73,572,483,312
255,./source1012/2019/CVE-2019-19274/python%cpython/3.7/a4d78362397fc3bced6ea80fbc7b5f4827aec55e_patch/equal_file_patch/1365736832.patch,5,317,34,21,11,10,351,283,68,282,191,91,91,56,35,1388,955,433,851,590,261,440,319,121,152,98,54,85,77,59,379,369,164
256,./source1012/2019/CVE-2019-19274/python%cpython/3.7/a4d78362397fc3bced6ea80fbc7b5f4827aec55e_patch/equal_file_patch/4cb08b6c0a.patch,11,495,73,25,13,12,547,441,106,409,296,113,96,59,37,1811,1283,528,1080,795,285,618,448,170,229,173,56,115,101,73,573,483,313
257,./source1012/2019/CVE-2019-19274/python%cpython/3.7/a4d78362397fc3bced6ea80fbc7b5f4827aec55e_patch/equal_file_patch/499c926fbe.patch,5,317,34,21,11,10,351,283,68,282,191,91,91,56,35,1388,955,433,851,590,261,440,319,121,152,98,54,85,77,59,379,369,164
258,./source1012/2019/CVE-2019-19479/OpenSC%OpenSC/master/c3f23b836e5a_patch/equal_file_patch/88eeb892.patch,1,3,1,0,0,0,3,1,2,0,0,0,2,1,1,4,2,2,6,2,4,1,0,1,0,0,0,0,0,0,7,4,7
259,./source1012/2019/CVE-2019-19479/OpenSC%OpenSC/master/c3f23b836e5a_patch/equal_file_patch/1dceff47.patch,1,3,1,0,0,0,3,1,2,0,0,0,2,1,1,4,2,2,6,2,4,1,0,1,0,0,0,0,0,0,7,4,7
260,./source1012/2019/CVE-2019-19479/OpenSC%OpenSC/master/c3f23b836e5a_patch/equal_file_patch/ba85ae75.patch,1,3,1,0,0,0,3,1,2,0,0,0,2,1,1,4,2,2,6,2,4,1,0,1,0,0,0,0,0,0,7,4,7
261,./source1012/2019/CVE-2019-19479/OpenSC%OpenSC/master/c3f23b836e5a_patch/equal_file_patch/4bd8cda9.patch,1,3,1,0,0,0,3,1,2,0,0,0,2,1,1,4,2,2,6,2,4,1,0,1,0,0,0,0,0,0,7,4,7
262,./source1012/2019/CVE-2019-19479/OpenSC%OpenSC/master/c3f23b836e5a_patch/equal_file_patch/3dede423e640.patch,1,3,1,0,0,0,3,1,2,0,0,0,2,1,1,4,2,2,6,2,4,1,0,1,0,0,0,0,0,0,7,4,7
263,./source1012/2019/CVE-2019-19479/OpenSC%OpenSC/master/c3f23b836e5a_patch/equal_file_patch/a763d03a.patch,1,3,1,0,0,0,3,1,2,0,0,0,2,1,1,4,2,2,6,2,4,1,0,1,0,0,0,0,0,0,7,4,7
264,./source1012/2019/CVE-2019-19531/torvalds%linux/master/1041f5092179_patch/equal_file_patch/1041f5092179.patch,1,2,1,0,0,0,0,0,0,0,0,0,0,0,0,2,1,1,2,1,1,0,0,0,0,0,0,1,1,1,2,2,2
265,./source1012/2019/CVE-2019-19531/torvalds%linux/master/1041f5092179_patch/equal_file_patch/28318f535030.patch,1,4,1,4,2,2,2,2,0,0,0,0,0,0,0,9,5,4,9,5,4,0,0,0,0,0,0,3,2,3,6,5,4
266,./source1012/2019/CVE-2019-19531/torvalds%linux/master/1041f5092179_patch/equal_file_patch/0af5cb349a2c.patch,1,4,1,4,2,2,2,2,0,0,0,0,0,0,0,9,5,4,9,5,4,0,0,0,0,0,0,3,2,3,6,5,4
267,./source1012/2019/CVE-2019-19531/torvalds%linux/master/1041f5092179_patch/equal_file_patch/6f0306d1bfbc.patch,1,2,1,0,0,0,0,0,0,0,0,0,0,0,0,3,1,2,3,1,2,0,0,0,0,0,0,2,1,2,3,2,3
268,./source1012/2019/CVE-2019-19531/torvalds%linux/master/1041f5092179_patch/equal_file_patch/c6dbef730762.patch,1,4,1,4,2,2,2,2,0,0,0,0,0,0,0,9,5,4,9,5,4,0,0,0,0,0,0,3,2,3,6,5,4
269,./source1012/2019/CVE-2019-19531/torvalds%linux/master/1041f5092179_patch/equal_file_patch/0cee54c890a4.patch,1,4,1,4,2,2,2,2,0,0,0,0,0,0,0,9,5,4,9,5,4,0,0,0,0,0,0,3,2,3,6,5,4
270,./source1012/2019/CVE-2019-20479/zmartzone%mod_auth_openidc/master/26fefea3a5fa_patch/equal_file_patch/e63066d.patch,2,31,8,7,3,4,69,30,39,19,10,9,3,1,2,137,55,82,54,20,34,29,10,19,11,5,6,34,26,29,95,73,87
271,./source1012/2019/CVE-2019-20479/zmartzone%mod_auth_openidc/master/26fefea3a5fa_patch/equal_file_patch/88c0d32c08ef.patch,1,1,1,0,0,0,3,0,3,1,0,1,0,0,0,8,0,8,3,0,3,3,0,3,0,0,0,3,0,3,15,0,15
272,./source1012/2019/CVE-2019-20479/zmartzone%mod_auth_openidc/master/26fefea3a5fa_patch/equal_file_patch/319f225ada04.patch,2,29,7,7,3,4,68,27,41,20,9,11,4,1,3,128,44,84,61,17,44,21,6,15,10,5,5,38,25,32,94,60,87
273,./source1012/2019/CVE-2019-20479/zmartzone%mod_auth_openidc/master/26fefea3a5fa_patch/equal_file_patch/d6a9361a4675.patch,2,31,8,7,3,4,75,30,45,20,10,10,3,1,2,140,55,85,59,20,39,28,10,18,11,5,6,36,26,31,98,73,90
274,./source1012/2019/CVE-2019-20479/zmartzone%mod_auth_openidc/master/26fefea3a5fa_patch/equal_file_patch/8ea550f34ce5.patch,1,2,1,0,0,0,9,3,6,3,1,2,0,0,0,28,11,17,7,3,4,11,4,7,0,0,0,4,4,3,21,20,19
275,./source1012/2019/CVE-2019-20479/zmartzone%mod_auth_openidc/master/26fefea3a5fa_patch/equal_file_patch/02bb87d.patch,2,29,7,7,3,4,67,27,40,18,9,9,3,1,2,115,44,71,55,17,38,17,6,11,11,5,6,34,23,28,87,60,80
276,./source1012/2019/CVE-2019-6110/openssh%openssh-portable/master/bdc6c63c80b5_patch/equal_file_patch/32dd2daa.patch,1,7,3,2,1,1,7,3,4,0,0,0,1,0,1,11,6,5,0,0,0,13,5,8,2,1,1,5,4,4,12,11,12
277,./source1012/2019/CVE-2019-6110/openssh%openssh-portable/master/bdc6c63c80b5_patch/equal_file_patch/fd10cf02.patch,1,3,3,0,0,0,7,3,4,0,0,0,1,0,1,0,0,0,0,0,0,13,5,8,0,0,0,2,2,2,4,2,4
278,./source1012/2019/CVE-2019-6110/openssh%openssh-portable/master/bdc6c63c80b5_patch/equal_file_patch/b3318946.patch,1,7,3,2,1,1,7,3,4,0,0,0,1,0,1,11,6,5,0,0,0,13,5,8,2,1,1,5,4,4,12,11,12
279,./source1012/2019/CVE-2019-6110/openssh%openssh-portable/master/bdc6c63c80b5_patch/equal_file_patch/022def7b.patch,1,7,3,2,1,1,7,3,4,0,0,0,1,0,1,11,6,5,0,0,0,13,5,8,2,1,1,5,4,4,12,11,12
280,./source1012/2019/CVE-2019-6110/openssh%openssh-portable/master/bdc6c63c80b5_patch/equal_file_patch/8bdc3bb7.patch,1,7,3,2,1,1,7,3,4,0,0,0,1,0,1,11,6,5,0,0,0,13,5,8,2,1,1,5,4,4,12,11,12
281,./source1012/2019/CVE-2019-6110/openssh%openssh-portable/master/bdc6c63c80b5_patch/equal_file_patch/60455a5d.patch,1,7,3,2,1,1,7,3,4,0,0,0,1,0,1,11,6,5,0,0,0,13,5,8,2,1,1,5,4,4,12,11,12
